фильм	NOUN
родился	VERB
благодаря	ADP
большому	ADJ
проекту	NOUN
100	NUM
лет	NOUN
настоящего	NOUN
который	PRON
проходил	VERB
в	ADP
доме	PROPN
мировых	ADJ
культур	NOUN
в	ADP
берлине	PROPN
с	ADP
2015	NUM
по	ADP
2019	NUM
год	NOUN
он	PRON
состоял	VERB
из	ADP
многочисленных	ADJ
творческих	ADJ
и	CCONJ
образовательных	ADJ
мероприятий	NOUN
и	CCONJ
значительную	ADJ
роль	NOUN
в	ADP
нем	PRON
играли	VERB
лекции	NOUN
самых	ADJ
разных	ADJ
гуманитарных	ADJ
исследователей	NOUN
работа	NOUN
михаэля	PROPN
буша	PROPN
его	PRON
личная	ADJ
интерпретация	NOUN
этого	DET
проекта	NOUN
в	ADP
формате	NOUN
экспериментального	ADJ
видеоколлажа	NOUN
главная	ADJ
идея	NOUN
которой	PRON
руководствовался	VERB
режиссер	NOUN
при	ADP
его	PRON
создании	NOUN
связана	VERB
с	ADP
тезисами	NOUN
о	ADP
философии	NOUN
истории	NOUN
вальтера	PROPN
беньямина	PROPN
и	CCONJ
в	ADP
частности	NOUN
с	ADP
его	DET
специфическим	ADJ
понимании	NOUN
времени	NOUN
фильм	NOUN
задал	VERB
тон	NOUN
структуре	NOUN
всей	DET
программы	NOUN
и	CCONJ
подарил	VERB
ей	PRON
своей	DET
название	NOUN
ойкономия	NOUN
изучает	VERB
природу	NOUN
современного	ADJ
финансового	ADJ
капитализма	NOUN
и	CCONJ
пытается	VERB
описать	VERB
столпы	NOUN
на	ADP
которых	PRON
он	PRON
держится	VERB
например	ADV
идею	NOUN
экономического	ADJ
роста	NOUN
зрителю	NOUN
предлагается	VERB
задуматься	VERB
в	ADP
какой	DET
момент	NOUN
и	CCONJ
почему	ADV
наша	DET
экономика	NOUN
может	VERB
существовать	VERB
только	PART
в	ADP
режиме	NOUN
роста	NOUN
а	CCONJ
также	PART
какую	DET
роль	NOUN
в	ADP
ней	PRON
играет	VERB
долг	NOUN
фильм	NOUN
позволяет	VERB
пристально	ADV
рассмотреть	VERB
ключевой	ADJ
элемент	NOUN
базиса	NOUN
нашего	DET
общественного	ADJ
устройства	NOUN
и	CCONJ
выявить	VERB
его	DET
порочную	ADJ
логику	NOUN
фильм	NOUN
марка	PROPN
баудера	PROPN
широко	ADV
говорит	VERB
о	ADP
проблемах	NOUN
глобального	ADJ
мира	NOUN
но	CCONJ
острее	ADV
всего	PRON
в	ADP
нем	PRON
отражаются	VERB
вопросы	NOUN
связанные	VERB
с	ADP
отношением	NOUN
человека	NOUN
и	CCONJ
окружающей	VERB
среды	NOUN
в	ADP
кадре	NOUN
появляются	VERB
ученые	NOUN
философы	NOUN
и	CCONJ
исследователи	NOUN
самого	ADJ
разного	ADJ
профиля	NOUN
которых	PRON
объединяет	VERB
одно	NUM
будущее	NOUN
нашей	DET
планеты	NOUN
и	CCONJ
обеспокоенность	NOUN
стремительно	ADV
ухудшающейся	VERB
экологической	ADJ
обстановкой	NOUN
фильм-эссе	NOUN
выполненный	VERB
в	ADP
традициях	NOUN
харуна	PROPN
фароки	PROPN
и	CCONJ
исследующий	VERB
природу	NOUN
видения	NOUN
на	ADP
предмете	NOUN
технологических	ADJ
систем	NOUN
слежения	NOUN
режиссер	NOUN
тео	PROPN
энтони	PROPN
прослеживает	VERB
историю	NOUN
техник	NOUN
наблюдения	NOUN
и	CCONJ
контроля	NOUN
от	ADP
френологии	NOUN
до	ADP
современных	ADJ
дронов	NOUN
демонстрируя	VERB
развитие	NOUN
визуальной	ADJ
культуры	NOUN
и	CCONJ
влияние	NOUN
технологий	NOUN
на	ADP
природу	NOUN
человека	NOUN
фильм	NOUN
описывает	VERB
мир	NOUN
тотального	ADJ
контроля	NOUN
рисуя	VERB
достаточно	ADV
тревожный	ADJ
антиутопический	ADJ
горизонт	NOUN
но	CCONJ
при	ADP
этом	PRON
сама	ADJ
картина	NOUN
очень	ADV
захватывающая	ADJ
зрелищная	ADJ
и	CCONJ
актуальная	ADJ
для	ADP
каждого	DET
из	ADP
нас	PRON
эта	DET
работа	NOUN
тима	PROPN
лейендеккера	PROPN
немного	ADV
выбивается	VERB
по	ADP
своей	DET
форме	NOUN
из	ADP
всей	DET
программы	NOUN
фильм	NOUN
в	ADP
меньшей	ADJ
степени	NOUN
можно	ADV
назвать	VERB
документальным	ADJ
потому	ADV
что	SCONJ
он	PRON
представляет	VERB
собой	PRON
коллаж	NOUN
состоящий	VERB
из	ADP
семи	NUM
разнородных	ADJ
эпизодов	NOUN
все	DET
они	PRON
выполнены	VERB
в	ADP
разных	ADJ
техниках	NOUN
и	CCONJ
с	ADP
нескольких	NUM
сторон	NOUN
рассматривают	VERB
резонансный	ADJ
кейс	NOUN
злоумышленного	ADJ
заражения	NOUN
вирусом	NOUN
вич	PROPN
на	ADP
секс-вечеринках	NOUN
в	ADP
городе	NOUN
гронингене	PROPN
в	ADP
нидерландах	PROPN
режиссер	NOUN
исследует	VERB
как	ADV
законодательные	ADJ
и	CCONJ
общественные	ADJ
установки	NOUN
определяют	VERB
наши	DET
желания	NOUN
формируют	VERB
понятия	NOUN
любви	NOUN
вины	NOUN
и	CCONJ
морали	NOUN
и	CCONJ
какую	DET
роль	NOUN
во	ADP
всех	DET
этих	DET
социальных	ADJ
процессах	NOUN
играют	VERB
такой	DET
нечеловеческий	ADJ
агент	NOUN
как	SCONJ
вирус	NOUN
в	ADP
эпоху	NOUN
эпидемии	NOUN
эти	DET
вопросы	NOUN
кажутся	VERB
мне	PRON
невероятно	ADV
актуальными	ADJ